##########
# .    ..#
#\######.#
#.####.# #
#.###....#
#..   ## #
#.# #.## #
#.#. ...%#
#...##.#.#
##########
