#################
# .......####...#
##.###.# ##.%.#.#
## ##.\ .. .#  .#
##.## #.###.=#.##
# ... ..####  ..#
# ##.##.####.##=#
#.##.# . ... . .#
#.###. # #.####.#
# .  o## #.#### #
#.# #.......###.#
#.. . # #.#.#  .#
#### ##.#.#.# #.#
### ... ..# o.#.#
#.# #.#.#.## ##.#
#.. ....# .. ...#
#################
