##############
#  .....#. ..#
# # ###...## #
#.#.. .#.###.#
#...## #o###.#
#.#### #.##. #
#.####.# ##.##
# #. .... .. #
#  .# ##.#.#.#
#.#....%.#\ .#
#.##.#.#. ## #
#. #.#.## ## #
## ...=##..  #
##############
