######################
#...... # ..##...=o  #
#.### #.#.#. #.#.### #
# ###..=  . #  . ### #
#.###.# # #   ##. ...#
#.......#.##.# ..### #
# ##.#.## ##.#.# ### #
#. . ....=#..... .  \#
#.#.#####. .###.#o##.#
#.#.###...# ......# .#
#.. .##.###.# #.#..#.#
# ##.. .. #.#...##.#.#
#.###.# #.. ### .# #.#
#.###.#..##.####. .#.#
#   ..##.##   ##.# #.#
#.###. ...# #.#..... #
#.....#.#  = . %#.## #
#.### #.. # ##.##o...#
# ### #.#..###....#.##
#... ...##...# # ##.##
#.########## . o... .#
######################
