########################
#########.#.. .. ..    #
##. ..###.  #.## #.# # #
## ##.##### # #.. .. =.#
#. ##\..###.%.  #.#.## #
#.#.  # ... ## ## ..## #
# #.#.##.##... ...#.. .#
# ..# ## ...# #.# ..# ##
#.#  . ##.#.#. ...#...##
#.## # .  #. .##.#..#. #
# ... ###.######=..#.#.#
# ###......###. .#.# #.#
#.....#.##.#...###. .# #
#.# #.#.##.# # ### ###.#
#... ..... . .=. ..... #
# ####.####.#.###.##.###
#o...# ###.    ##..#.###
#.##.#####.#.#o. .#..###
#.. ....##.....## #.####
#.#.#.# . .##.#.. ...###
#.=.#.#.##.#. ..##.#  ##
#.#  .o  ...o##..   #.##
#. .#.#.#### .. #.#... #
########################
