####################
########...... .##.#
####...# #.#.##....#
## ..#.#.# #.#.#.#.#
#..#o. .     == ...#
##.#.## ###.#.##.###
##   .#.##=... #.###
#. ##......# #.%.###
##.## ## # #   #.###
#. .#... #.# ##....#
#.#. .## .. . ..##.#
#.#.#####.# ## # ..#
# #.### ..#.##.#.#o#
# .o\.. # ........ #
## ##.##. #.##.#.#.#
##.##.## ##.## #...#
##.## .  . .##...#.#
#.. ##### #.  #.##.#
#.#  .......#  .   #
####################
